w w w w w w w w w
w _ p _ w _ _ _ w
w _ _ _ _ _ _ _ w
w _ _ _ _ _ _ _ w
w _ _ _ f _ _ _ w
w _ _ _ _ _ _ _ w
w _ _ _ _ w w w w
w _ _ _ _ w w w w
w w w w w w w w w