w  w  t  _1 w  w  w  _  
w  w  w  _1 t  w  w  _  
w  w  t  _1 w  w  w  _  
w  w  w  _1 t  w  w  _  
w  w  t  _1 w  w  w  _  
w  w  w  _1 t  w  w  _  
w  w  t  _1 w  w  w  _  
w  w  w  _1 t  w  w  _  
w  w  t  _1 w  w  w  _  
w  w  w  _1 t  w  w  _  
w  w  t  _1 w  w  w  _  
w  w  w  _1 t  w  w  _  
w  w  t  _1 w  w  w  _  
w  w  w  _1 w  w  w  _  
w  _1 _1 _1 _1 _1 w  _  
w  _1 _  _  _  _1 w  _  
w  _1 _1 p  _1 _1 w  _  
w  w  w  w  w  w  w  _  
