name: ???
creator: ???
w  w  w  w  w  w  w  
w  w  w  g  w  w  w  
w  w  w  _  t  w  w  
w  w  t  _  w  w  w  
w  w  w  _  t  w  w  
w  w  t  _  w  w  w  
w  w  w  _  t  w  w  
w  w  t  _  w  w  w  
w  w  w  _  t  w  w  
w  w  t  _  w  w  w  
w  w  w  _  t  w  w  
w  w  t  _  w  w  w  
w  w  w  _  t  w  w  
w  w  t  _  w  w  w  
w  w  w  _  t  w  w  
w  w  t  _  w  w  w  
w  w  w  _  t  w  w  
w  w  t  _  w  w  w  
w  w  w  _  t  w  w  
w  w  t  _  w  w  w  
w  w  w  _  t  w  w  
w  w  t  _  w  w  w  
w  w  w  _  t  w  w  
w  w  t  _  w  w  w  
w  w  w  _  t  w  w  
w  w  t  _  w  w  w  
w  w  w  _  t  w  w  
w  w  t  _  w  w  w  
w  w  w  _  t  w  w  
w  w  t  _  w  w  w  
w  w  w  _  t  w  w  
w  w  t  _  w  w  w  
w  w  w  _  t  w  w  
w  w  t  _  w  w  w  
w  w  w  _  t  w  w  
w  w  t  _  w  w  w  
w  w  w  _  t  w  w  
w  w  t  _  w  w  w  
w  w  w  _  t  w  w  
w  w  t  _  w  w  w  
w  w  w  _  t  w  w  
w  w  t  _  w  w  w  
w  w  w  _  t  w  w  
w  w  t  _  w  w  w  
w  w  w  _  t  w  w  
w  w  t  _  w  w  w  
w  w  w  _  t  w  w  
w  w  t  _  w  w  w  
w  w  w  _  t  w  w  
w  w  t  _  w  w  w  
w  w  w  _  t  w  w  
w  w  t  _  w  w  w  
w  w  w  _  t  w  w  
w  w  t  _  w  w  w  
w  w  w  _  t  w  w  
w  w  t  _  w  w  w  
w  w  w  _  t  w  w  
w  w  t  _  w  w  w  
w  w  w  _  t  w  w  
w  w  t  _  w  w  w  
w  w  w  _  t  w  w  
w  w  t  _  w  w  w  
w  w  w  _  t  w  w  
w  w  t  _  w  w  w  
w  w  w  _  t  w  w  
w  w  t  _  w  w  w  
w  w  w  _  t  w  w  
w  w  t  _  w  w  w  
w  w  w  _  t  w  w  
w  w  t  _  w  w  w  
w  w  w  _  t  w  w  
w  w  t  _  w  w  w  
w  w  w  _  t  w  w  
w  w  t  _  w  w  w  
w  w  w  _  t  w  w  
w  w  t  _  w  w  w  
w  w  w  _  t  w  w  
w  w  t  _  w  w  w  
w  w  w  _  t  w  w  
w  w  t  _  w  w  w  
w  w  w  _  t  w  w  
w  w  t  _  w  w  w  
w  w  w  _  t  w  w  
w  w  t  _  w  w  w  
w  w  w  _  t  w  w  
w  w  t  _  w  w  w  
w  w  w  _  t  w  w  
w  w  t  _  w  w  w  
w  w  w  _  t  w  w  
w  w  t  _  w  w  w  
w  w  w  _  t  w  w  
w  w  t  _  w  w  w  
w  w  w  _  t  w  w  
w  w  t  _  w  w  w  
w  w  w  _  t  w  w  
w  w  t  _  w  w  w  
w  w  w  _  t  w  w  
w  w  t  _  w  w  w  
w  w  w  _  t  w  w  
w  w  t  _  w  w  w  
w  w  w  _  t  w  w  
w  w  t  _  w  w  w  
w  w  w  _  t  w  w  
w  w  t  _  w  w  w  
w  w  w  _  t  w  w  
w  w  t  _  w  w  w  
w  w  w  _  t  w  w  
w  w  t  _  w  w  w  
w  w  w  _  t  w  w  
w  w  t  _  w  w  w  
w  w  w  _  t  w  w  
w  w  t  _  w  w  w  
w  w  w  _  t  w  w  
w  w  t  _  w  w  w  
w  w  w  _  t  w  w  
w  w  t  _  w  w  w  
w  w  w  _  t  w  w  
w  w  t  _  w  w  w  
w  w  w  _  t  w  w  
w  w  t  _  w  w  w  
w  w  w  _  t  w  w  
w  w  t  _  w  w  w  
w  w  w  _  t  w  w  
w  w  t  _  w  w  w  
w  w  w  _  t  w  w  
w  w  t  _  w  w  w  
w  w  w  _  t  w  w  
w  w  t  _  w  w  w  
w  w  w  _  t  w  w  
w  w  t  _  w  w  w  
w  w  w  _  t  w  w  
w  w  t  _  w  w  w  
w  w  w  _  t  w  w  
w  w  t  _  w  w  w  
w  w  w  _  t  w  w  
w  w  t  _  w  w  w  
w  w  w  _  t  w  w  
w  w  t  _  w  w  w  
w  w  w  _  t  w  w  
w  w  t  _  w  w  w  
w  w  w  _  t  w  w  
w  w  t  _  w  w  w  
w  w  w  _  t  w  w  
w  w  t  _  w  w  w  
w  w  w  _  t  w  w  
w  w  t  _  w  w  w  
w  w  w  _  t  w  w  
w  w  t  _  w  w  w  
w  w  w  _  t  w  w  
w  w  t  _  w  w  w  
w  w  w  _  t  w  w  
w  w  t  _1 w  w  w  
w  w  w  _  t  w  w  
w  w  t  _  w  w  w  
w  w  w  _  t  w  w  
w  w  t  _1 w  w  w  
w  w  w  _  t  w  w  
w  w  t  _  w  w  w  
w  w  w  _1 t  w  w  
w  w  t  _  w  w  w  
w  w  w  _1 t  w  w  
w  w  t  _1 w  w  w  
w  w  w  _1 w  w  w  
w  _  _  _1 _  _  w  
w  _  _  _1 _  _  w  
w  _  _  p  _  _  w  
w  w  w  w  w  w  w  